name	taxonomy_id	taxonomy_lvl	kraken_assigned_reads	added_reads	new_est_reads	fraction_total_reads
Streptococcus sp. LPB0220	2610896	S	10841	2297	13138	0.02512
Streptococcus sp. HSISM1	1316408	S	10487	2070	12557	0.02401
Streptococcus sp. Marseille-Q6470	2972784	S	3620	493	4113	0.00786
Streptococcus sp. oral taxon 061	712623	S	3220	453	3673	0.00702
Streptococcus sp. oral taxon 431	712633	S	2445	172	2617	0.00500
Streptococcus sp. Marseille-Q3533	2759692	S	2234	191	2425	0.00464
Streptococcus sp. A12	1759399	S	1701	205	1906	0.00364
Streptococcus sp. 116-D4	2598453	S	1023	95	1118	0.00214
Streptococcus sp. NPS 308	1902136	S	388	64	452	0.00086
Streptococcus sp. FDAARGOS_192	1839799	S	249	186	435	0.00083
Streptococcus sp. 1643	2576376	S	172	76	248	0.00047
Streptococcus sp. HSISS2	1316411	S	99	88	187	0.00036
Streptococcus sp. oral taxon 064	712624	S	90	86	176	0.00034
Streptococcus sp. HSISS3	1316412	S	70	59	129	0.00025
Streptococcus sp. KS 6	2598457	S	22	7	29	0.00006
Streptococcus sp. HSISS1	1316410	S	21	244	265	0.00051
Streptococcus sp. zg-86	2664091	S	18	0	18	0.00003
Streptococcus parasanguinis	1318	S	18756	1949	20705	0.03959
Streptococcus mitis	28037	S	13113	1827	14940	0.02856
Streptococcus infantis	68892	S	5996	444	6440	0.01231
Streptococcus oralis	1303	S	5801	826	6627	0.01267
Streptococcus salivarius	1304	S	5701	1460	7161	0.01369
Streptococcus sanguinis	1305	S	3930	107	4037	0.00772
Streptococcus pneumoniae	1313	S	3518	5840	9358	0.01789
Streptococcus lactarius	684066	S	1849	110	1959	0.00375
Streptococcus australis	113107	S	1359	500	1859	0.00355
Streptococcus ilei	1156431	S	1025	381	1406	0.00269
Streptococcus gwangjuense	1433513	S	940	210	1150	0.00220
Streptococcus cristatus	45634	S	901	51	952	0.00182
Streptococcus gordonii	1302	S	878	31	909	0.00174
Streptococcus pseudopneumoniae	257758	S	806	194	1000	0.00191
Streptococcus toyakuensis	2819619	S	776	251	1027	0.00196
Streptococcus intermedius	1338	S	280	55	335	0.00064
Streptococcus anginosus	1328	S	132	86	218	0.00042
Streptococcus constellatus	76860	S	42	35	77	0.00015
Streptococcus koreensis	2382163	S	455	212	667	0.00128
Streptococcus rubneri	1234680	S	452	146	598	0.00114
Streptococcus thermophilus	1308	S	410	57	467	0.00089
Streptococcus vestibularis	1343	S	343	36	379	0.00072
Streptococcus suis	1307	S	218	66	284	0.00054
Streptococcus mutans	1309	S	155	11	166	0.00032
Streptococcus equi	1336	S	46	1	47	0.00009
Streptococcus dysgalactiae	1334	S	29	3	32	0.00006
Streptococcus pyogenes	1314	S	65	3	68	0.00013
Streptococcus parauberis	1348	S	57	3	60	0.00011
Streptococcus agalactiae	1311	S	49	2038	2087	0.00399
Streptococcus parasuis	1501662	S	48	17	65	0.00012
Streptococcus oriscaviae	2781599	S	41	0	41	0.00008
Streptococcus pluranimalium	82348	S	40	1	41	0.00008
Streptococcus gallolyticus	315405	S	36	15	51	0.00010
Streptococcus respiraculi	2021971	S	34	0	34	0.00007
Streptococcus iniae	1346	S	29	2	31	0.00006
Streptococcus periodonticum	2490633	S	28	15	43	0.00008
Streptococcus alactolyticus	29389	S	27	2	29	0.00006
Streptococcus sobrinus	1310	S	24	0	24	0.00005
Streptococcus merionis	400065	S	23	0	23	0.00004
Streptococcus himalayensis	1888195	S	21	0	21	0.00004
Streptococcus urinalis	149016	S	21	1	22	0.00004
Streptococcus acidominimus	1326	S	20	0	20	0.00004
Streptococcus canis	1329	S	19	1	20	0.00004
Streptococcus pseudoporcinus	361101	S	18	1	19	0.00004
Streptococcus ferus	1345	S	18	0	18	0.00003
Streptococcus ruminantium	1917441	S	17	9	26	0.00005
Streptococcus porcinus	1340	S	17	0	17	0.00003
Streptococcus halotolerans	1814128	S	17	0	17	0.00003
Streptococcus equinus	1335	S	17	2	19	0.00004
Streptococcus uberis	1349	S	16	0	16	0.00003
Streptococcus milleri	33040	S	15	13	28	0.00005
Streptococcus ratti	1341	S	14	0	14	0.00003
Streptococcus marmotae	1825069	S	13	0	13	0.00002
Streptococcus pantholopis	1811193	S	11	0	11	0.00002
Streptococcus chenjunshii	2173853	S	11	0	11	0.00002
Lactococcus lactis	1358	S	17	42	59	0.00011
Lactococcus cremoris	1359	S	17	5	22	0.00004
Lactococcus raffinolactis	1366	S	12	0	12	0.00002
Granulicatella adiacens	46124	S	6620	231	6851	0.01310
Granulicatella elegans	137732	S	154	28	182	0.00035
Carnobacterium divergens	2748	S	13	1	14	0.00003
Carnobacterium maltaromaticum	2751	S	12	1	13	0.00002
Jeotgalibaca porci	1868793	S	13	6	19	0.00004
Dolosigranulum pigrum	29394	S	16	0	16	0.00003
Lacticaseibacillus rhamnosus	47715	S	10	5	15	0.00003
Pediococcus pentosaceus	1255	S	10	12	22	0.00004
Abiotrophia defectiva	46125	S	173	15	188	0.00036
Enterococcus faecium	1352	S	28	42	70	0.00013
Enterococcus faecalis	1351	S	18	13	31	0.00006
Vagococcus fluvialis	2738	S	12	1	13	0.00002
Gemella sanguinis	84135	S	1574	113	1687	0.00323
Gemella haemolysans	1379	S	358	19	377	0.00072
Gemella morbillorum	29391	S	90	10	100	0.00019
Exiguobacterium sp. N4-1P	2051906	S	34	3	37	0.00007
Bacillus cereus	1396	S	21	137	158	0.00030
Bacillus wiedmannii	1890302	S	20	9	29	0.00006
Bacillus sp. JY-23	2933872	S	11	2	13	0.00002
Weizmannia coagulans	1398	S	18	29	47	0.00009
Paenibacillus sp. SYP-B4298	2996034	S	11	14	25	0.00005
Paenibacillus mucilaginosus	61624	S	12	38	50	0.00010
Staphylococcus aureus	1280	S	10	43	53	0.00010
Ureibacillus thermosphaericus	51173	S	10	17	27	0.00005
Veillonella dispar	39778	S	18588	2211	20799	0.03977
Veillonella atypica	39777	S	14429	284	14713	0.02813
Veillonella rogosae	423477	S	9278	483	9761	0.01866
Veillonella sp. S12025-13	2682455	S	6762	1410	8172	0.01562
Veillonella nakazawae	2682456	S	5718	1649	7367	0.01408
Veillonella parvula	29466	S	4857	97	4954	0.00947
Veillonella rodentium	248315	S	276	2	278	0.00053
Megasphaera stantonii	2144175	S	37	7	44	0.00008
Megasphaera massiliensis	1232428	S	25	5	30	0.00006
Megasphaera hexanoica	1675036	S	22	8	30	0.00006
Megasphaera elsdenii	907	S	19	12	31	0.00006
Dialister pneumosintes	39950	S	12	10	22	0.00004
Selenomonas sp. oral taxon 478	712538	S	42	13	55	0.00011
Selenomonas sp. oral taxon 136	713030	S	34	9	43	0.00008
Selenomonas sp. oral taxon 920	1884263	S	23	1	24	0.00005
Selenomonas sp. oral taxon 126	712528	S	14	0	14	0.00003
Selenomonas sputigena	69823	S	28	0	28	0.00005
Selenomonas timonae	2754044	S	20	2	22	0.00004
Pelosinus fermentans	365349	S	15	2	17	0.00003
Lachnoanaerobaculum umeaense	617123	S	555	11	566	0.00108
Blautia wexlerae	418240	S	126	97	223	0.00043
Blautia obeum	40520	S	42	26	68	0.00013
Blautia sp. SC05B48	2479767	S	23	57	80	0.00015
Blautia sp. NBRC 113351	2877527	S	12	4	16	0.00003
Blautia argi	1912897	S	14	4	18	0.00003
Blautia hansenii	1322	S	12	7	19	0.00004
Blautia producta	33035	S	12	2	14	0.00003
Enterocloster bolteae	208479	S	107	17	124	0.00024
Enterocloster asparagiformis	333367	S	17	0	17	0.00003
[Ruminococcus] gnavus	33038	S	40	19	59	0.00011
[Ruminococcus] torques	33039	S	40	26	66	0.00013
[Ruminococcus] lactaris	46228	S	22	4	26	0.00005
[Clostridium] scindens	29347	S	29	2	31	0.00006
Lachnoclostridium phocaeense	1871021	S	16	3	19	0.00004
Lachnoclostridium phytofermentans	66219	S	15	0	15	0.00003
Lachnoclostridium sp. YL32	1834196	S	13	22	35	0.00007
[Clostridium] hylemonae	89153	S	10	1	11	0.00002
Roseburia hominis	301301	S	36	14	50	0.00010
Roseburia intestinalis	166486	S	29	23	52	0.00010
Coprococcus comes	410072	S	27	16	43	0.00008
Coprococcus catus	116085	S	22	8	30	0.00006
Coprococcus sp. ART55/1	751585	S	11	5	16	0.00003
Coprococcus eutactus	33043	S	10	4	14	0.00003
Anaerostipes hadrus	649756	S	58	14	72	0.00014
Butyrivibrio fibrisolvens	831	S	19	3	22	0.00004
Butyrivibrio crossotus	45851	S	18	5	23	0.00004
Butyrivibrio proteoclasticus	43305	S	12	5	17	0.00003
Anaerobutyricum hallii	39488	S	61	17	78	0.00015
Lacrimispora xylanolytica	29375	S	16	2	18	0.00003
Lacrimispora saccharolytica	84030	S	15	5	20	0.00004
Lacrimispora sphenoides	29370	S	12	3	15	0.00003
Dorea longicatena	88431	S	36	20	56	0.00011
Dorea formicigenerans	39486	S	12	8	20	0.00004
Lachnospira eligens	39485	S	28	2	30	0.00006
Marvinbryantia formatexigens	168384	S	25	1	26	0.00005
Pseudobutyrivibrio xylanivorans	185007	S	23	0	23	0.00004
Simiaoa sunii	2763672	S	19	6	25	0.00005
Sellimonas intestinalis	1653434	S	14	1	15	0.00003
Qiania dongpingensis	2763669	S	14	1	15	0.00003
Wansuia hejianensis	2763667	S	12	0	12	0.00002
Herbinix luporum	1679721	S	11	9	20	0.00004
[Clostridium] colinum	36835	S	11	0	11	0.00002
Wujia chipingensis	2763670	S	11	5	16	0.00003
Faecalicatena sp. Marseille-Q4148	2823316	S	10	3	13	0.00002
Mogibacterium diversum	114527	S	698	24	722	0.00138
Mogibacterium pumilum	86332	S	41	0	41	0.00008
Flintibacter sp. KGMB00164	2610895	S	11	0	11	0.00002
Faecalibacterium prausnitzii	853	S	64	79	143	0.00027
Faecalibacterium sp. I2-3-92	2929490	S	10	33	43	0.00008
Ruminococcus bicirculans	1160721	S	30	2	32	0.00006
Ruminococcus bovis	2564099	S	11	0	11	0.00002
Dysosmobacter sp. Marseille-Q4140	2830675	S	20	4	24	0.00005
Dysosmobacter welbionis	2093857	S	10	6	16	0.00003
Vescimonas coprocola	2714355	S	18	10	28	0.00005
Anaerotruncus colihominis	169435	S	16	7	23	0.00004
Subdoligranulum variabile	214851	S	13	2	15	0.00003
Flavonifractor plautii	292800	S	13	1	14	0.00003
Ruthenibacterium lactatiformans	1550024	S	12	1	13	0.00002
Clostridium sp. M62/1	411486	S	30	17	47	0.00009
Clostridium sp. SY8519	1042156	S	17	1	18	0.00003
Clostridium botulinum	1491	S	22	48	70	0.00013
Clostridium estertheticum	238834	S	14	3	17	0.00003
Hungatella hathewayi	154046	S	41	5	46	0.00009
Filifactor alocis	143361	S	60	7	67	0.00013
Clostridioides difficile	1496	S	13	7	20	0.00004
Eubacterium sp. c-25	2841037	S	18	3	21	0.00004
Eubacterium ventriosum	39496	S	11	8	19	0.00004
Desulfoscipio gibsoniae	102134	S	13	0	13	0.00002
Bulleidia sp. zg-1006	2806552	S	34	0	34	0.00007
Faecalibacillus intestinalis	1982626	S	28	2	30	0.00006
[Clostridium] innocuum	1522	S	20	1	21	0.00004
Parvimonas micra	33033	S	57	13	70	0.00013
Finegoldia magna	1260	S	10	0	10	0.00002
Schaalia odontolytica	1660	S	10831	924	11755	0.02247
Schaalia meyeri	52773	S	758	42	800	0.00153
Schaalia sp. 19OD2882	2794089	S	55	1	56	0.00011
Schaalia sp. JY-X169	2758572	S	33	0	33	0.00006
Schaalia sp. ZJ405	2709403	S	21	0	21	0.00004
Schaalia turicensis	131111	S	86	16	102	0.00020
Schaalia cardiffensis	181487	S	44	1	45	0.00009
Schaalia radingae	131110	S	30	1	31	0.00006
Actinomyces sp. oral taxon 171	706438	S	242	72	314	0.00060
Actinomyces sp. oral taxon 414	712122	S	173	15	188	0.00036
Actinomyces sp. oral taxon 169	712116	S	119	79	198	0.00038
Actinomyces sp. HMT 175	2789425	S	32	54	86	0.00016
Actinomyces sp. 432	2057798	S	21	1	22	0.00004
Actinomyces sp. MAS-1	2755559	S	21	1	22	0.00004
Actinomyces sp. Z16	2079536	S	15	1	16	0.00003
Actinomyces sp. Chiba101	1851395	S	14	1	15	0.00003
Actinomyces oris	544580	S	405	302	707	0.00135
Actinomyces pacaensis	1852377	S	316	10	326	0.00062
Actinomyces naeslundii	1655	S	120	18	138	0.00026
Actinomyces viscosus	1656	S	40	4	44	0.00008
Actinomyces howellii	52771	S	39	1	40	0.00008
Actinomyces radicidentis	111015	S	32	5	37	0.00007
Actinomyces respiraculi	2744574	S	32	1	33	0.00006
Actinomyces faecalis	2722820	S	32	1	33	0.00006
Actinomyces procaprae	2560010	S	27	2	29	0.00006
Actinomyces qiguomingii	2057800	S	20	0	20	0.00004
Actinomyces slackii	52774	S	13	0	13	0.00002
Actinomyces marmotae	2737173	S	13	1	14	0.00003
Actinomyces gaoshouyii	1960083	S	12	1	13	0.00002
Actinomyces wuliandei	2057743	S	11	0	11	0.00002
Pauljensenia hongkongensis	178339	S	272	49	321	0.00061
Mobiluncus curtisii	2051	S	34	2	36	0.00007
Winkia neuii	33007	S	28	12	40	0.00008
Trueperella pyogenes	1661	S	12	2	14	0.00003
Nanchangia anserum	2692125	S	13	0	13	0.00002
Rothia mucilaginosa	43675	S	4907	219	5126	0.00980
Rothia dentocariosa	2047	S	3012	260	3272	0.00626
Rothia aeria	172042	S	1197	63	1260	0.00241
Arthrobacter sp. Helios	2828862	S	10	22	32	0.00006
Arthrobacter agilis	37921	S	11	0	11	0.00002
Arthrobacter crystallopoietes	37928	S	11	0	11	0.00002
Arthrobacter alpinus	656366	S	11	11	22	0.00004
Kocuria rhizophila	72000	S	17	9	26	0.00005
Kocuria palustris	71999	S	14	2	16	0.00003
Kocuria turfanensis	388357	S	12	1	13	0.00002
Glutamicibacter protophormiae	37930	S	13	8	21	0.00004
Paeniglutamicibacter sp. Y32M11	2853258	S	19	2	21	0.00004
Microbacterium sp. PM5	2014534	S	32	14	46	0.00009
Microbacterium sp. TPU 3598	1938334	S	16	25	41	0.00008
Microbacterium sp. No. 7	1714373	S	15	13	28	0.00005
Microbacterium sp. Clip185	3025663	S	10	11	21	0.00004
Microbacterium foliorum	104336	S	21	14	35	0.00007
Microbacterium aurum	36805	S	18	15	33	0.00006
Microbacterium oleivorans	273677	S	15	5	20	0.00004
Microbacterium azadirachtae	582680	S	14	6	20	0.00004
Microbacterium lemovicicum	1072463	S	13	4	17	0.00003
Microbacterium oryzae	743009	S	11	4	15	0.00003
Microbacterium terricola	344163	S	11	4	15	0.00003
Microbacterium oxydans	82380	S	10	48	58	0.00011
Agromyces sp. H17E-10	2932244	S	13	8	21	0.00004
Agromyces flavus	589382	S	13	7	20	0.00004
Agromyces badenianii	2080742	S	12	7	19	0.00004
Agromyces archimandritae	2781962	S	11	5	16	0.00003
Rathayibacter festucae	110937	S	10	13	23	0.00004
Clavibacter michiganensis	28447	S	29	32	61	0.00012
Leifsonia sp. ZF2019	2781978	S	11	9	20	0.00004
Leifsonia shinshuensis	150026	S	11	3	14	0.00003
Plantibacter sp. PA-3-X8	2480625	S	11	21	32	0.00006
Agreia sp. COWG	2773266	S	37	7	44	0.00008
Microcella flavibacter	1804990	S	11	9	20	0.00004
Subtercola sp. AK-R2A1-2	2895559	S	13	1	14	0.00003
Frigoribacterium sp. SL97	2994664	S	11	6	17	0.00003
Herbiconiux sp. SALV-R1	2735133	S	13	4	17	0.00003
Cnuibacter physcomitrellae	1619308	S	14	5	19	0.00004
Microterricola viridarii	412690	S	14	5	19	0.00004
Homoserinibacter sp. YIM 151385	2985506	S	10	5	15	0.00003
Cellulomonas sp. zg.B89	2968083	S	12	4	16	0.00003
Cellulomonas sp. Y8	2591145	S	11	3	14	0.00003
Cellulomonas sp. zg.Y338	2968084	S	11	1	12	0.00002
Cellulomonas palmilytica	2608402	S	26	14	40	0.00008
Cellulomonas flavigena	1711	S	10	2	12	0.00002
Brachybacterium huguangmaarense	1652028	S	10	13	23	0.00004
Janibacter limosus	53458	S	16	7	23	0.00004
Janibacter melonis	262209	S	11	2	13	0.00002
Phycicoccus sp. HDW14	2714941	S	18	2	20	0.00004
Phycicoccus endophyticus	1690220	S	13	1	14	0.00003
Arsenicicoccus sp. oral taxon 190	1658671	S	13	2	15	0.00003
Brevibacterium sp. CS2	2575923	S	10	3	13	0.00002
Brevibacterium luteolum	199591	S	14	4	18	0.00003
Brevibacterium casei	33889	S	12	23	35	0.00007
Serinicoccus hydrothermalis	1758689	S	14	6	20	0.00004
Cellulosimicrobium cellulans	1710	S	17	23	40	0.00008
Xylanimonas allomyrinae	2509459	S	16	5	21	0.00004
Georgenia sp. TF02-10	2917725	S	13	2	15	0.00003
Georgenia faecalis	2483799	S	12	1	13	0.00002
Georgenia yuyongxinii	2589797	S	10	0	10	0.00002
Ruania zhangjianzhongii	2603206	S	13	0	13	0.00002
Occultella kanbiaonis	2675754	S	10	2	12	0.00002
Pengzhenrongella sicca	2819238	S	17	2	19	0.00004
Luteimicrobium xylanilyticum	1133546	S	14	1	15	0.00003
Sanguibacter sp. HDW7	2714931	S	14	1	15	0.00003
Kytococcus sedentarius	1276	S	11	2	13	0.00002
Mycolicibacterium smegmatis	1772	S	16	32	48	0.00009
Mycolicibacterium sediminis	1286180	S	13	7	20	0.00004
Mycolicibacterium chitae	1792	S	12	10	22	0.00004
Mycolicibacterium moriokaense	39691	S	11	3	14	0.00003
Mycolicibacterium litorale	758802	S	11	15	26	0.00005
Mycobacterium diernhoferi	1801	S	11	24	35	0.00007
Mycobacterium dioxanotrophicus	482462	S	11	32	43	0.00008
Mycobacteroides abscessus	36809	S	11	20	31	0.00006
Corynebacterium matruchotii	43768	S	376	22	398	0.00076
Corynebacterium marinum	349751	S	14	30	44	0.00008
Corynebacterium efficiens	152794	S	13	8	21	0.00004
Rhodococcus fascians	1828	S	17	9	26	0.00005
Rhodococcus opacus	37919	S	10	76	86	0.00016
Nocardia asteroides	1824	S	35	18	53	0.00010
Nocardia huaxiensis	2755382	S	14	4	18	0.00003
Nocardia brasiliensis	37326	S	13	4	17	0.00003
Nocardia cyriacigeorgica	135487	S	13	8	21	0.00004
Nocardia otitidiscaviarum	1823	S	10	2	12	0.00002
Gordonia sp. PP30	2935861	S	15	16	31	0.00006
Gordonia polyisoprenivorans	84595	S	13	17	30	0.00006
Tsukamurella paurometabola	2061	S	14	5	19	0.00004
Tsukamurella tyrosinosolvens	57704	S	10	5	15	0.00003
Streptomyces sp. SN-593	659352	S	15	8	23	0.00004
Streptomyces sp. ST1015	1848900	S	13	17	30	0.00006
Streptomyces sp. HM190	2695266	S	12	32	44	0.00008
Streptomyces sp. 3214.6	1882757	S	11	30	41	0.00008
Streptomyces sp. T12	477697	S	10	29	39	0.00007
Streptomyces alboniger	132473	S	14	22	36	0.00007
Streptomyces hygroscopicus	1912	S	14	87	101	0.00019
Streptomyces venezuelae	54571	S	25	36	61	0.00012
Streptomyces tsukubensis	83656	S	17	8	25	0.00005
Streptomyces lienomycini	284035	S	13	32	45	0.00009
Streptomyces roseirectus	2768066	S	13	8	21	0.00004
Streptomyces marincola	2878388	S	13	2	15	0.00003
Streptomyces armeniacus	83291	S	12	2	14	0.00003
Streptomyces xanthii	2768069	S	12	7	19	0.00004
Streptomyces bathyalis	2710756	S	12	1	13	0.00002
Streptomyces noursei	1971	S	12	54	66	0.00013
Streptomyces formicae	1616117	S	12	19	31	0.00006
Streptomyces harbinensis	1176198	S	12	5	17	0.00003
Streptomyces galilaeus	33899	S	11	17	28	0.00005
Streptomyces coeruleorubidus	116188	S	11	28	39	0.00007
Streptomyces griseorubiginosus	67304	S	11	13	24	0.00005
Streptomyces lydicus	47763	S	11	54	65	0.00012
Streptomyces peucetius	1950	S	11	7	18	0.00003
Streptomyces phaeolivaceus	2653200	S	11	13	24	0.00005
Streptomyces tubbatahanensis	2923272	S	11	3	14	0.00003
Streptomyces gilvosporeus	553510	S	10	8	18	0.00003
Streptomyces clavuligerus	1901	S	10	3	13	0.00002
Streptomyces luteoverticillatus	66425	S	10	6	16	0.00003
Kitasatospora setae	2066	S	10	6	16	0.00003
Streptacidiphilus sp. P02-A3a	2704468	S	13	3	16	0.00003
Streptantibioticus cattleyicolor	29303	S	13	5	18	0.00003
Yinghuangia sp. ASG 101	2896848	S	12	1	13	0.00002
Arachnia rubra	1547448	S	532	9	541	0.00103
Arachnia propionica	1750	S	51	1	52	0.00010
Cutibacterium acnes	1747	S	99	9	108	0.00021
Tessaracoccus defluvii	1285901	S	12	9	21	0.00004
Microlunatus sagamiharensis	546874	S	18	2	20	0.00004
Propioniciclava coleopterorum	2714937	S	15	5	20	0.00004
Propioniciclava sp. MC1595	2760308	S	14	4	18	0.00003
Propionibacterium freudenreichii	1744	S	10	24	34	0.00007
Propionibacterium australiense	119981	S	10	0	10	0.00002
Nocardioides sp. S-1144	2582905	S	22	6	28	0.00005
Nocardioides sp. LMS-CY	2840457	S	21	5	26	0.00005
Nocardioides sp. zg-1228	2763008	S	20	7	27	0.00005
Nocardioides sp. S5	2017486	S	19	10	29	0.00006
Nocardioides sp. B-3	2895565	S	17	3	20	0.00004
Nocardioides sp. cx-173	2898796	S	14	3	17	0.00003
Nocardioides sp. WS12	2486272	S	13	1	14	0.00003
Nocardioides sp. HDW12B	2714939	S	13	2	15	0.00003
Nocardioides sp. W7	2931390	S	12	3	15	0.00003
Nocardioides sp. zg-536	2803858	S	12	4	16	0.00003
Nocardioides sp. Kera G14	2884264	S	11	1	12	0.00002
Nocardioides sp. CF8	110319	S	11	6	17	0.00003
Nocardioides aquaticus	160826	S	31	7	38	0.00007
Nocardioides cynanchi	2558918	S	30	4	34	0.00007
Nocardioides anomalus	2712223	S	28	6	34	0.00007
Nocardioides euryhalodurans	2518370	S	16	4	20	0.00004
Nocardioides panacis	2849501	S	14	2	16	0.00003
Nocardioides mesophilus	433659	S	14	2	16	0.00003
Nocardioides okcheonensis	2894081	S	13	5	18	0.00003
Nocardioides humi	449461	S	13	4	17	0.00003
Nocardioides piscis	2714938	S	12	6	18	0.00003
Nocardioides dokdonensis	450734	S	11	6	17	0.00003
Nocardioides rotundus	1774216	S	10	3	13	0.00002
Aeromicrobium erythreum	2041	S	10	6	16	0.00003
Pimelobacter simplex	2045	S	29	14	43	0.00008
Marmoricola scoriae	642780	S	17	5	22	0.00004
Friedmanniella luteola	546871	S	11	1	12	0.00002
Kribbella qitaiheensis	1544730	S	19	1	20	0.00004
Kribbella sp. CA-293567	3002436	S	12	1	13	0.00002
Actinopolymorpha singaporensis	117157	S	16	0	16	0.00003
Amycolatopsis sp. DSM 110486	2865832	S	17	3	20	0.00004
Amycolatopsis sp. HUAS 11-8	2995223	S	15	2	17	0.00003
Amycolatopsis sp. FDAARGOS 1241	2778070	S	14	3	17	0.00003
Amycolatopsis sp. Hca4	2742131	S	10	6	16	0.00003
Amycolatopsis pretoriensis	218821	S	14	7	21	0.00004
Amycolatopsis acidiphila	715473	S	11	2	13	0.00002
Pseudonocardia sp. DSM 110487	2865833	S	19	1	20	0.00004
Pseudonocardia sp. HH130630-07	1690815	S	11	9	20	0.00004
Pseudonocardia broussonetiae	2736640	S	16	5	21	0.00004
Pseudonocardia dioxanivorans	240495	S	14	3	17	0.00003
Pseudonocardia autotrophica	2074	S	12	3	15	0.00003
Saccharopolyspora erythraea	1836	S	20	5	25	0.00005
Saccharopolyspora gloriosae	455344	S	12	6	18	0.00003
Saccharothrix syringae	103733	S	17	4	21	0.00004
Saccharothrix espanaensis	103731	S	16	3	19	0.00004
Saccharothrix sp. 6-C	2781735	S	13	3	16	0.00003
Kutzneria sp. CA-103260	2802641	S	13	1	14	0.00003
Kutzneria albida	43357	S	12	1	13	0.00002
Kutzneria chonburiensis	1483604	S	11	1	12	0.00002
Lentzea sp. HUAS12	2951806	S	10	1	11	0.00002
Kibdelosporangium phytohabitans	860235	S	13	1	14	0.00003
Allokutzneria albata	211114	S	13	2	15	0.00003
Actinokineospora sp. UTMC 2448	2268449	S	11	2	13	0.00002
Micromonospora sp. B006	2201999	S	12	29	41	0.00008
Micromonospora sp. WMMA2032	2039870	S	11	10	21	0.00004
Micromonospora sp. WMMC415	2675222	S	11	4	15	0.00003
Micromonospora rifamycinica	291594	S	12	7	19	0.00004
Micromonospora krabiensis	307121	S	11	4	15	0.00003
Actinoplanes sp. L3-i22	2836373	S	22	16	38	0.00007
Actinoplanes sp. N902-109	649831	S	14	4	18	0.00003
Actinoplanes sp. OR16	946334	S	13	5	18	0.00003
Actinoplanes derwentensis	113562	S	18	1	19	0.00004
Actinoplanes friuliensis	196914	S	18	2	20	0.00004
Actinoplanes missouriensis	1866	S	11	2	13	0.00002
Actinoplanes ianthinogenes	122358	S	11	3	14	0.00003
Dactylosporangium roseum	47989	S	19	14	33	0.00006
Dactylosporangium aurantiacum	35754	S	12	1	13	0.00002
Dactylosporangium fulvum	53359	S	10	6	16	0.00003
Catellatospora sp. IY07-71	2728827	S	22	6	28	0.00005
Phytohabitans flavus	1076124	S	10	2	12	0.00002
Polymorphospora rubra	338584	S	19	4	23	0.00004
Actinocatenispora thailandica	227318	S	12	2	14	0.00003
Couchioplanes caeruleus	56438	S	13	3	16	0.00003
Bifidobacterium longum	216816	S	39	41	80	0.00015
Bifidobacterium adolescentis	1680	S	37	23	60	0.00011
Bifidobacterium angulatum	1683	S	16	2	18	0.00003
Bifidobacterium dentium	1689	S	12	0	12	0.00002
Bifidobacterium pseudolongum	1694	S	11	0	11	0.00002
Bifidobacterium pseudocatenulatum	28026	S	10	2	12	0.00002
Actinomadura sp. WMMB 499	1219491	S	12	1	13	0.00002
Actinomadura sp. WMMA1423	2591108	S	11	1	12	0.00002
Actinomadura madurae	1993	S	13	2	15	0.00003
Actinomadura verrucosospora	46165	S	13	2	15	0.00003
Thermomonospora amylolytica	1411117	S	11	2	13	0.00002
Nonomuraea sp. ATCC 55076	1909395	S	15	2	17	0.00003
Nonomuraea gerenzanensis	93944	S	13	2	15	0.00003
Nonomuraea phyllanthi	2219224	S	11	1	12	0.00002
Nonomuraea coxensis	404386	S	10	1	11	0.00002
Streptosporangium roseum	2001	S	13	1	14	0.00003
Streptosporangium sp. 'caverna'	2202249	S	11	1	12	0.00002
Nocardiopsis alba	53437	S	11	6	17	0.00003
Thermobifida halotolerans	483545	S	12	2	14	0.00003
Streptomonospora litoralis	2498135	S	11	1	12	0.00002
Frankia inefficax	298654	S	20	7	27	0.00005
Modestobacter marinus	477641	S	11	1	12	0.00002
Blastococcus saxobsidens	138336	S	11	1	12	0.00002
Jiangella sp. DSM 45060	1798224	S	21	2	23	0.00004
Jiangella alkaliphila	419479	S	10	1	11	0.00002
Nakamurella multipartita	53461	S	11	1	12	0.00002
Jatrophihabitans sp. SB3-54	2944128	S	11	0	11	0.00002
Catenulispora acidiphila	304895	S	19	1	20	0.00004
Lancefieldella parvula	1382	S	812	10	822	0.00157
Olsenella sp. oral taxon 807	712411	S	58	1	59	0.00011
Olsenella uli	133926	S	14	0	14	0.00003
Collinsella aerofaciens	74426	S	31	6	37	0.00007
Collinsella sp. zg1085	2844380	S	12	0	12	0.00002
Aquihabitans sp. G128	2849779	S	76	9	85	0.00016
Aquihabitans sp. Kera 3	2884263	S	51	3	54	0.00010
Iamia sp. SCSIO 61187	2722752	S	36	6	42	0.00008
Iamia majanohamensis	467976	S	33	6	39	0.00007
Actinomarinicola tropica	2789776	S	30	3	33	0.00006
Ilumatobacter coccineus	467094	S	38	1	39	0.00007
Conexibacter sp. SYSU D00693	2812560	S	21	2	23	0.00004
Conexibacter sp. DBS9H8	2937801	S	13	0	13	0.00002
Conexibacter sp. S30A1	2937800	S	10	0	10	0.00002
Conexibacter woesei	191495	S	30	2	32	0.00006
Capillimicrobium parvum	2884022	S	29	2	31	0.00006
Paraconexibacter antarcticus	2949664	S	17	0	17	0.00003
Miltoncostaea marina	2843215	S	12	0	12	0.00002
Miltoncostaea oceani	2843216	S	11	0	11	0.00002
Baekduia sp. 0141_2	2997333	S	19	1	20	0.00004
Baekduia soli	496014	S	16	1	17	0.00003
Oscillatoria nigro-viridis	482564	S	35	28	63	0.00012
Microcoleus vaginatus	119532	S	29	10	39	0.00007
Microcystis aeruginosa	1126	S	15	8	23	0.00004
Prochlorococcus marinus	1219	S	15	6	21	0.00004
Prevotella melaninogenica	28132	S	121927	7980	129907	0.24837
Prevotella histicola	470565	S	26319	796	27115	0.05184
Prevotella veroralis	28137	S	20526	923	21449	0.04101
Prevotella jejuni	1177574	S	9240	756	9996	0.01911
Prevotella intermedia	28131	S	2669	237	2906	0.00556
Prevotella nigrescens	28133	S	2003	276	2279	0.00436
Prevotella denticola	28129	S	1639	202	1841	0.00352
Prevotella sp. oral taxon 299	652716	S	1235	26	1261	0.00241
Prevotella sp. oral taxon 475	712471	S	114	1	115	0.00022
Prevotella sp. E15-22	2937774	S	45	1	46	0.00009
Prevotella sp. Rep29	2691580	S	33	0	33	0.00006
Prevotella sp. E13-17	2913616	S	28	0	28	0.00005
Prevotella sp. E9-3	2913621	S	24	0	24	0.00005
Prevotella sp. E2-28	2913620	S	18	0	18	0.00003
Prevotella sp. E2-25	2913619	S	10	46	56	0.00011
Prevotella scopos	589437	S	1486	142	1628	0.00311
Prevotella oris	28135	S	1391	40	1431	0.00274
Prevotella fusca	589436	S	454	19	473	0.00090
Prevotella corporis	28128	S	186	8	194	0.00037
Prevotella copri	165179	S	165	2	167	0.00032
Prevotella multiformis	282402	S	140	12	152	0.00029
Prevotella dentalis	52227	S	124	5	129	0.00025
Prevotella herbatica	2801997	S	79	0	79	0.00015
Prevotella bryantii	77095	S	79	0	79	0.00015
Prevotella ruminicola	839	S	47	0	47	0.00009
Hoylesella enoeca	76123	S	724	36	760	0.00145
Hoylesella buccalis	28127	S	66	3	69	0.00013
Pseudoprevotella muciniphila	2133944	S	89	0	89	0.00017
Paraprevotella xylaniphila	454155	S	46	3	49	0.00009
Porphyromonas gingivalis	837	S	2369	128	2497	0.00477
Porphyromonas endodontalis	28124	S	1522	53	1575	0.00301
Porphyromonas sp. oral taxon 275	712435	S	1027	3	1030	0.00197
Porphyromonas somerae	322095	S	33	1	34	0.00007
Porphyromonas asaccharolytica	28123	S	32	0	32	0.00006
Porphyromonas crevioricanis	393921	S	23	0	23	0.00004
Porphyromonas cangingivalis	36874	S	22	0	22	0.00004
Bacteroides uniformis	820	S	75	125	200	0.00038
Bacteroides heparinolyticus	28113	S	70	12	82	0.00016
Bacteroides thetaiotaomicron	818	S	57	16	73	0.00014
Bacteroides zoogleoformans	28119	S	56	11	67	0.00013
Bacteroides fragilis	817	S	44	34	78	0.00015
Bacteroides cellulosilyticus	246787	S	43	30	73	0.00014
Bacteroides caccae	47678	S	30	11	41	0.00008
Bacteroides eggerthii	28111	S	28	8	36	0.00007
Bacteroides stercoris	46506	S	27	4	31	0.00006
Bacteroides faecis	674529	S	20	8	28	0.00005
Bacteroides salyersiae	291644	S	19	2	21	0.00004
Bacteroides nordii	291645	S	19	1	20	0.00004
Bacteroides helcogenes	290053	S	18	0	18	0.00003
Bacteroides xylanisolvens	371601	S	18	41	59	0.00011
Bacteroides sp. M10	2763022	S	10	10	20	0.00004
Bacteroides intestinalis	329854	S	15	1	16	0.00003
Bacteroides ovatus	28116	S	12	40	52	0.00010
Phocaeicola vulgatus	821	S	174	117	291	0.00056
Phocaeicola dorei	357276	S	74	51	125	0.00024
Phocaeicola salanitronis	376805	S	28	1	29	0.00006
Phocaeicola coprophilus	387090	S	20	5	25	0.00005
Tannerella forsythia	28112	S	563	36	599	0.00115
Tannerella serpentiformis	712710	S	189	1	190	0.00036
Parabacteroides merdae	46503	S	34	6	40	0.00008
Parabacteroides distasonis	823	S	24	36	60	0.00011
Parabacteroides faecis	1217282	S	10	0	10	0.00002
Alistipes onderdonkii	328813	S	39	8	47	0.00009
Alistipes megaguti	2364787	S	26	1	27	0.00005
Alistipes communis	2585118	S	26	2	28	0.00005
Alistipes finegoldii	214856	S	23	9	32	0.00006
Alistipes shahii	328814	S	23	8	31	0.00006
Alistipes dispar	2585119	S	19	1	20	0.00004
Alistipes senegalensis	1288121	S	14	2	16	0.00003
Alistipes indistinctus	626932	S	13	0	13	0.00002
Alistipes ihumii	1470347	S	10	0	10	0.00002
Muribaculum intestinale	1796646	S	25	1	26	0.00005
Muribaculum gordoncarteri	2530390	S	11	2	13	0.00002
Duncaniella dubosii	2518971	S	11	5	16	0.00003
Sodaliphilus pleomorphus	2606626	S	14	0	14	0.00003
Petrimonas mucosa	1642646	S	16	5	21	0.00004
Barnesiella viscericola	397865	S	30	1	31	0.00006
Coprobacter secundus	1501392	S	14	1	15	0.00003
Odoribacter splanchnicus	28118	S	18	22	40	0.00008
Capnocytophaga gingivalis	1017	S	434	18	452	0.00086
Capnocytophaga sputigena	1019	S	296	32	328	0.00063
Capnocytophaga ochracea	1018	S	96	45	141	0.00027
Capnocytophaga sp. FDAARGOS_737	2545799	S	22	3	25	0.00005
Capnocytophaga sp. oral taxon 878	1316596	S	16	2	18	0.00003
Capnocytophaga sp. oral taxon 323	1705617	S	13	15	28	0.00005
Capnocytophaga haemolytica	45243	S	61	1	62	0.00012
Capnocytophaga endodontalis	2708117	S	40	6	46	0.00009
Capnocytophaga leadbetteri	327575	S	22	3	25	0.00005
Capnocytophaga canimorsus	28188	S	10	1	11	0.00002
Flavobacterium sp. Sr18	935222	S	57	15	72	0.00014
Flavobacterium sp. IMCC36791	3003262	S	29	5	34	0.00007
Flavobacterium sp. F-340	2893886	S	27	10	37	0.00007
Flavobacterium sp. IMCC36793	3003263	S	22	3	25	0.00005
Flavobacterium sp. N1994	2986827	S	21	2	23	0.00004
Flavobacterium sp. N1736	2986823	S	21	9	30	0.00006
Flavobacterium sp. K5-23	2746225	S	20	6	26	0.00005
Flavobacterium sp. IMCC36792	3016339	S	19	5	24	0.00005
Flavobacterium sp. F-70	2893884	S	19	7	26	0.00005
Flavobacterium sp. TR2	2977321	S	18	18	36	0.00007
Flavobacterium sp. CLA17	2724135	S	17	5	22	0.00004
Flavobacterium sp. M31R6	2739062	S	17	5	22	0.00004
Flavobacterium sp. N3904	2986835	S	14	4	18	0.00003
Flavobacterium sp. I3-2	2748319	S	14	13	27	0.00005
Flavobacterium sp. MDT1-60	1979344	S	13	5	18	0.00003
Flavobacterium sp. F-29	2893883	S	13	4	17	0.00003
Flavobacterium sp. N2270	2986831	S	13	3	16	0.00003
Flavobacterium sp. IMCC34774	3003257	S	12	2	14	0.00003
Flavobacterium sp. CECT 9288	2845819	S	12	27	39	0.00007
Flavobacterium sp. KBS0721	1179672	S	12	8	20	0.00004
Flavobacterium sp. N2038	2986829	S	11	6	17	0.00003
Flavobacterium sp. IMCC34518	3003623	S	11	3	14	0.00003
Flavobacterium sp. 140616W15	2478552	S	11	3	14	0.00003
Flavobacterium sp. N2820	2986834	S	10	2	12	0.00002
Flavobacterium sp. CJ74	2294119	S	10	0	10	0.00002
Flavobacterium sangjuense	2518177	S	33	3	36	0.00007
Flavobacterium nackdongense	2547394	S	25	3	28	0.00005
Flavobacterium psychrophilum	96345	S	21	28	49	0.00009
Flavobacterium gilvum	1492737	S	18	3	21	0.00004
Flavobacterium commune	1306519	S	17	3	20	0.00004
Flavobacterium ammoniigenes	1751095	S	14	5	19	0.00004
Flavobacterium ammonificans	1751056	S	14	5	19	0.00004
Flavobacterium cyclinae	2895947	S	13	6	19	0.00004
Flavobacterium azooxidireducens	1871076	S	13	1	14	0.00003
Flavobacterium crocinum	2183896	S	12	6	18	0.00003
Flavobacterium channae	2897181	S	11	7	18	0.00003
Flavobacterium bizetiae	2704140	S	11	9	20	0.00004
Flavobacterium anhuiense	459526	S	10	9	19	0.00004
Flavobacterium arcticum	1784713	S	10	1	11	0.00002
Chryseobacterium indologenes	253	S	13	40	53	0.00010
Kaistella jeonii	266749	S	16	2	18	0.00003
Kaistella carnis	1241979	S	11	8	19	0.00004
Epilithonimonas vandammei	2487072	S	12	18	30	0.00006
Blattabacterium cuenoti	1653831	S	23	4	27	0.00005
Hymenobacter sp. PAMC 26628	1484118	S	14	18	32	0.00006
Hymenobacter sp. 5317J-9	2932250	S	11	24	35	0.00007
Hymenobacter psoromatis	1484116	S	17	7	24	0.00005
Spirosoma sp. KCTC 42546	2520506	S	12	0	12	0.00002
Spirosoma pollinicola	2057025	S	19	0	19	0.00004
Spirosoma endbachense	2666025	S	19	3	22	0.00004
Spirosoma radiotolerans	1379870	S	17	1	18	0.00003
Cytophaga hutchinsonii	985	S	20	4	24	0.00005
Tellurirhabdus rosea	2674997	S	15	4	19	0.00004
Dyadobacter sp. CY22	2909339	S	13	3	16	0.00003
Dyadobacter fermentans	94254	S	12	1	13	0.00002
Runella slithyformis	106	S	13	1	14	0.00003
Chryseolinea soli	2321403	S	12	0	12	0.00002
Bernardetia litoralis	999	S	11	0	11	0.00002
Mucilaginibacter sp. 14171R-50	2703789	S	14	0	14	0.00003
Mucilaginibacter sp. 21P	2778902	S	12	0	12	0.00002
Mucilaginibacter sp. SMC90	2929803	S	11	0	11	0.00002
Mucilaginibacter mallensis	652787	S	18	0	18	0.00003
Mucilaginibacter mali	2740462	S	17	0	17	0.00003
Mucilaginibacter jinjuensis	1176721	S	13	0	13	0.00002
Mucilaginibacter ginsenosidivorans	398053	S	12	0	12	0.00002
Mucilaginibacter gotjawali	1550579	S	12	0	12	0.00002
Mucilaginibacter paludis	423351	S	10	0	10	0.00002
Mucilaginibacter gossypii	551996	S	10	27	37	0.00007
Mucilaginibacter ginsenosidivorax	862126	S	10	0	10	0.00002
Mucilaginibacter celer	2305508	S	10	0	10	0.00002
Pedobacter sp. D749	2856523	S	32	6	38	0.00007
Pedobacter sp. KBS0701	2578106	S	14	2	16	0.00003
Pedobacter cryoconitis	188932	S	43	3	46	0.00009
Pedobacter riviphilus	2766984	S	15	2	17	0.00003
Pedobacter roseus	336820	S	10	2	12	0.00002
Sphingobacterium sp. ML3W	1538644	S	18	16	34	0.00007
Sphingobacterium sp. SRCM116780	2907623	S	10	6	16	0.00003
Chitinophaga sp. R8	2920382	S	11	2	13	0.00002
Chitinophaga sp. HK235	2952571	S	11	3	14	0.00003
Chitinophaga oryzae	2725414	S	11	2	13	0.00002
Panacibacter ginsenosidivorans	1813871	S	48	2	50	0.00010
Ferruginibacter lapsinanis	563172	S	20	2	22	0.00004
Ferruginibacter albus	2875540	S	16	2	18	0.00003
Flavisolibacter tropicus	1492898	S	12	2	14	0.00003
Flavihumibacter fluminis (ex Park et al. 2022)	2838157	S	12	0	12	0.00002
Filimonas lacunae	477680	S	17	3	20	0.00004
Lacibacter sp. S13-6-22	2760713	S	17	1	18	0.00003
Pseudobacter ginsenosidimutans	661488	S	14	2	16	0.00003
Paraflavitalea soli	2315862	S	12	1	13	0.00002
Niastella koreensis	354356	S	11	2	13	0.00002
Pseudocnuella soli	2502779	S	11	2	13	0.00002
Rhodocaloribacter litoris	2558931	S	12	0	12	0.00002
Rhodothermus marinus	29549	S	10	0	10	0.00002
Gemmatimonas groenlandica	2732249	S	16	2	18	0.00003
Gemmatirosa kalamazoonensis	861299	S	30	1	31	0.00006
Vibrio kanaloae	170673	S	3726	1274	5000	0.00956
Vibrio plantisponsor	664643	S	2005	123	2128	0.00407
Vibrio diabolicus	50719	S	28	58	86	0.00016
Vibrio parahaemolyticus	670	S	36	8	44	0.00008
Vibrio alginolyticus	663	S	26	94	120	0.00023
Vibrio toranzoniae	1194427	S	147	55	202	0.00039
Vibrio cholerae	666	S	92	71	163	0.00031
Vibrio ziniensis	2711221	S	85	4	89	0.00017
Vibrio splendidus	29497	S	39	28	67	0.00013
Vibrio crassostreae	246167	S	38	18	56	0.00011
Vibrio cyclitrophicus	47951	S	24	11	35	0.00007
Vibrio vulnificus	672	S	17	1	18	0.00003
Vibrio gallaecicus	552386	S	17	1	18	0.00003
Vibrio anguillarum	55601	S	17	17	34	0.00007
Vibrio coralliirubri	1516159	S	16	9	25	0.00005
Vibrio celticus	446372	S	15	9	24	0.00005
Vibrio fluvialis	676	S	15	11	26	0.00005
Vibrio chagasii	170679	S	11	1	12	0.00002
Vibrio gigantis	296199	S	10	2	12	0.00002
Vibrio pelagius	28169	S	10	1	11	0.00002
Vibrio artabrorum	446374	S	10	1	11	0.00002
Haemophilus parainfluenzae	729	S	5292	387	5679	0.01086
Haemophilus parahaemolyticus	735	S	811	32	843	0.00161
Haemophilus influenzae	727	S	80	60	140	0.00027
Haemophilus haemolyticus	726	S	62	6	68	0.00013
Haemophilus sp. oral taxon 036	712310	S	20	2	22	0.00004
Haemophilus pittmaniae	249188	S	11	0	11	0.00002
Aggregatibacter sp. 2125159857	2820817	S	183	17	200	0.00038
Aggregatibacter sp. Marseille-P9115	2866570	S	28	5	33	0.00006
Aggregatibacter sp. oral taxon 513	712150	S	24	5	29	0.00006
Aggregatibacter aphrophilus	732	S	34	2	36	0.00007
Aggregatibacter segnis	739	S	19	3	22	0.00004
Pasteurella multocida	747	S	25	55	80	0.00015
Pseudoalteromonas prydzensis	182141	S	2362	106	2468	0.00472
Pseudoalteromonas rhizosphaerae	2518973	S	642	53	695	0.00133
Pseudoalteromonas sp. KAN5	2916633	S	45	95	140	0.00027
Pseudoalteromonas sp. SiA1	2839744	S	17	73	90	0.00017
Pseudoalteromonas sp. SCSIO 43095	2894202	S	15	12	27	0.00005
Pseudoalteromonas sp. DL-6	1390185	S	11	6	17	0.00003
Pseudoalteromonas sp. SCSIO 43101	2822847	S	10	2	12	0.00002
Pseudoalteromonas mariniglutinosa	206042	S	88	103	191	0.00037
Pseudoalteromonas aliena	247523	S	39	3	42	0.00008
Pseudoalteromonas nigrifaciens	28109	S	26	44	70	0.00013
Pseudoalteromonas arctica	394751	S	18	4	22	0.00004
Pseudoalteromonas carrageenovora	227	S	15	1	16	0.00003
Pseudoalteromonas espejiana	28107	S	12	0	12	0.00002
Pseudoalteromonas rubra	43658	S	11	0	11	0.00002
Pseudoalteromonas translucida	166935	S	11	6	17	0.00003
Idiomarina loihiensis	135577	S	81	9	90	0.00017
Alteromonas macleodii	28108	S	11	3	14	0.00003
Pseudomonas sp. OE 28.3	2745519	S	16	81	97	0.00019
Pseudomonas sp. C27(2019)	2604941	S	10	0	10	0.00002
Pseudomonas sp. KNUC1026	2893890	S	10	3	13	0.00002
Pseudomonas fluorescens	294	S	91	72	163	0.00031
Pseudomonas veronii	76761	S	16	45	61	0.00012
Pseudomonas aeruginosa	287	S	36	234	270	0.00052
Pseudomonas citronellolis	53408	S	17	15	32	0.00006
Pseudomonas putida	303	S	55	64	119	0.00023
Pseudomonas fulva	47880	S	10	11	21	0.00004
Pseudomonas syringae	317	S	14	31	45	0.00009
Pseudomonas sessilinigenes	658629	S	44	118	162	0.00031
Pseudomonas chlororaphis	587753	S	22	23	45	0.00009
Pseudomonas fragi	296	S	17	7	24	0.00005
Pseudomonas taetrolens	47884	S	15	0	15	0.00003
Pseudomonas knackmussii	65741	S	14	5	19	0.00004
Pseudomonas pohangensis	364197	S	13	0	13	0.00002
Pseudomonas psychrotolerans	237610	S	10	1	11	0.00002
Stutzerimonas stutzeri	316	S	22	13	35	0.00007
Halopseudomonas litoralis	797277	S	10	1	11	0.00002
Denitrificimonas caeni	521720	S	16	1	17	0.00003
Lysobacter enzymogenes	69	S	52	16	68	0.00013
Lysobacter capsici	435897	S	18	33	51	0.00010
Lysobacter antibioticus	84531	S	14	2	16	0.00003
Lysobacter oculi	2698682	S	13	2	15	0.00003
Lysobacter solisilvae	2763317	S	12	1	13	0.00002
Lysobacter alkalisoli	2591633	S	10	1	11	0.00002
Xanthomonas translucens	343	S	106	76	182	0.00035
Xanthomonas sacchari	56458	S	19	7	26	0.00005
Xanthomonas campestris	339	S	19	10	29	0.00006
Stenotrophomonas maltophilia	40324	S	76	78	154	0.00029
Stenotrophomonas rhizophila	216778	S	12	2	14	0.00003
Thermomonas carbonis	1463158	S	36	6	42	0.00008
Thermomonas sp. HDW16	2714945	S	15	3	18	0.00003
Thermomonas sp. XSG	2771436	S	10	4	14	0.00003
Thermomonas aquatica	2202149	S	16	7	23	0.00004
Luteimonas sp. JM171	1896164	S	16	3	19	0.00004
Luteimonas sp. MC1572	2799325	S	11	7	18	0.00003
Pseudoxanthomonas suwonensis	314722	S	13	12	25	0.00005
Arenimonas daejeonensis	370777	S	14	4	18	0.00003
Rhodanobacter thiooxydans	416169	S	11	10	21	0.00004
Frateuria edaphi	2898793	S	11	9	20	0.00004
Acinetobacter sp. TTH0-4	1646498	S	42	15	57	0.00011
Acinetobacter sp. CS-2	2798861	S	26	21	47	0.00009
Acinetobacter sp. TGL-Y2	1407071	S	15	1	16	0.00003
Acinetobacter sp. F9	2853158	S	11	23	34	0.00007
Acinetobacter baumannii	470	S	22	122	144	0.00028
Acinetobacter junii	40215	S	38	9	47	0.00009
Acinetobacter johnsonii	40214	S	34	33	67	0.00013
Acinetobacter pseudolwoffii	2053287	S	32	39	71	0.00014
Acinetobacter lwoffii	28090	S	24	32	56	0.00011
Acinetobacter indicus	756892	S	14	4	18	0.00003
Acinetobacter piscicola	2006115	S	11	3	14	0.00003
Acinetobacter wuhouensis	1879050	S	10	3	13	0.00002
Acinetobacter larvae	1789224	S	10	0	10	0.00002
Psychrobacter sp. DAB_AL43B	1028416	S	38	1	39	0.00007
Psychrobacter sp. WY6	2708350	S	19	18	37	0.00007
Psychrobacter sp. P11F6	1699621	S	18	18	36	0.00007
Psychrobacter sp. G	571800	S	13	34	47	0.00009
Psychrobacter urativorans	45610	S	18	0	18	0.00003
Psychrobacter arcticus	334543	S	16	1	17	0.00003
Psychrobacter cryohalolentis	330922	S	11	16	27	0.00005
Moraxella osloensis	34062	S	36	7	43	0.00008
Klebsiella pneumoniae	573	S	37	351	388	0.00074
Enterobacter hormaechei	158836	S	21	103	124	0.00024
Escherichia coli	562	S	19	73	92	0.00018
Salmonella enterica	28901	S	15	185	200	0.00038
Shigella flexneri	623	S	16	137	153	0.00029
Serratia marcescens	615	S	16	35	51	0.00010
Rahnella aquatilis	34038	S	11	7	18	0.00003
Pantoea agglomerans	549	S	11	7	18	0.00003
Pantoea dispersa	59814	S	10	2	12	0.00002
Buchnera aphidicola	9	S	15	3	18	0.00003
Morganella morganii	582	S	18	6	24	0.00005
Halomonas sp. XH26	2557993	S	14	72	86	0.00016
Halomonas campaniensis	213554	S	11	42	53	0.00010
Halomonas alkaliphila	272774	S	10	31	41	0.00008
Aeromonas media	651	S	25	35	60	0.00011
Aeromonas salmonicida	645	S	19	27	46	0.00009
Cardiobacterium hominis	2718	S	101	3	104	0.00020
Cardiobacterium sp. Marseille-Q4385	2866573	S	12	0	12	0.00002
Legionella pneumophila	446	S	12	9	21	0.00004
Solimonas sp. K1W22B-7	2303331	S	17	0	17	0.00003
Neisseria sicca	490	S	2325	447	2772	0.00530
Neisseria subflava	28449	S	1795	277	2072	0.00396
Neisseria mucosa	488	S	1760	533	2293	0.00438
Neisseria sp. oral taxon 014	641148	S	1424	105	1529	0.00292
Neisseria sp. ZJ106	2912188	S	23	0	23	0.00004
Neisseria sp. KEM232	655307	S	15	0	15	0.00003
Neisseria sp. ZJ785	2709396	S	12	0	12	0.00002
Neisseria flavescens	484	S	1199	222	1421	0.00272
Neisseria macacae	496	S	463	148	611	0.00117
Neisseria meningitidis	487	S	386	382	768	0.00147
Neisseria elongata	495	S	277	21	298	0.00057
Neisseria lactamica	486	S	111	37	148	0.00028
Neisseria cinerea	483	S	103	13	116	0.00022
Neisseria gonorrhoeae	485	S	62	15	77	0.00015
Neisseria brasiliensis	2666100	S	15	2	17	0.00003
Neisseria dentiae	194197	S	14	0	14	0.00003
Neisseria bacilliformis	267212	S	13	0	13	0.00002
Neisseria animalis	492	S	13	0	13	0.00002
Neisseria weaveri	28091	S	12	0	12	0.00002
Neisseria zalophi	640030	S	12	0	12	0.00002
Neisseria musculi	1815583	S	11	0	11	0.00002
Neisseria chenwenguii	1853278	S	11	0	11	0.00002
Morococcus cerebrosus	1056807	S	100	40	140	0.00027
Kingella oralis	505	S	46	1	47	0.00009
Kingella denitrificans	502	S	17	1	18	0.00003
Eikenella corrodens	539	S	37	1	38	0.00007
Aquaspirillum sp. LM1	1938604	S	79	10	89	0.00017
Acidovorax sp. KKS102	358220	S	47	28	75	0.00014
Acidovorax sp. T1	1858609	S	45	101	146	0.00028
Acidovorax sp. RAC01	1842533	S	37	16	53	0.00010
Acidovorax sp. 1608163	2478662	S	35	6	41	0.00008
Acidovorax sp. JMULE5	2518343	S	34	9	43	0.00008
Acidovorax sp. YS12	2738413	S	16	10	26	0.00005
Acidovorax sp. HDW3	2714923	S	11	4	15	0.00003
Acidovorax sp. NCPPB 2350	2940487	S	11	2	13	0.00002
Acidovorax sp. GBBC 1281	2940492	S	11	9	20	0.00004
Acidovorax sp. 5MLIR	2949090	S	11	2	13	0.00002
Acidovorax carolinensis	553814	S	81	77	158	0.00030
Acidovorax temperans	80878	S	50	59	109	0.00021
Acidovorax radicis	758826	S	39	5	44	0.00008
Acidovorax avenae	80867	S	26	39	65	0.00012
Acidovorax monticola	1926868	S	14	4	18	0.00003
Acidovorax antarcticus	2743470	S	14	7	21	0.00004
Variovorax sp. PAMC 28711	1795631	S	25	2	27	0.00005
Variovorax sp. WDL1	207745	S	23	28	51	0.00010
Variovorax sp. RKNM96	2681552	S	22	9	31	0.00006
Variovorax sp. HW608	1034889	S	21	2	23	0.00004
Variovorax sp. PBL-H6	434009	S	18	29	47	0.00009
Variovorax sp. PAMC28562	2762323	S	18	0	18	0.00003
Variovorax sp. PBS-H4	434008	S	17	9	26	0.00005
Variovorax sp. RA8	662548	S	14	8	22	0.00004
Variovorax sp. PAMC26660	2762322	S	11	2	13	0.00002
Variovorax sp. SRS16	282217	S	10	28	38	0.00007
Variovorax paradoxus	34073	S	87	46	133	0.00025
Variovorax boronicumulans	436515	S	15	14	29	0.00006
Rhodoferax sp. AJA081-3	2752316	S	64	3	67	0.00013
Rhodoferax sp. PAMC 29310	2822760	S	43	4	47	0.00009
Rhodoferax sp. MIZ03	2798804	S	30	1	31	0.00006
Rhodoferax sp. BAB1	2741720	S	20	4	24	0.00005
Rhodoferax saidenbachensis	1484693	S	49	4	53	0.00010
Rhodoferax koreense	1842727	S	42	13	55	0.00011
Rhodoferax antarcticus	81479	S	32	1	33	0.00006
Rhodoferax sediminis	2509614	S	31	3	34	0.00007
Rhodoferax ferrireducens	192843	S	29	1	30	0.00006
Rhodoferax aquaticus	2527691	S	25	2	27	0.00005
Polaromonas naphthalenivorans	216465	S	144	17	161	0.00031
Polaromonas sp. JS666	296591	S	49	61	110	0.00021
Polaromonas vacuolata	37448	S	22	3	25	0.00005
Hydrogenophaga sp. RAC07	1842537	S	24	6	30	0.00006
Hydrogenophaga sp. PBL-H3	434010	S	23	20	43	0.00008
Hydrogenophaga sp. SL48	2806347	S	23	7	30	0.00006
Hydrogenophaga sp. PAMC20947	2565558	S	20	1	21	0.00004
Hydrogenophaga sp. PBC	795665	S	16	8	24	0.00005
Hydrogenophaga sp. BPS33	2651974	S	16	7	23	0.00004
Hydrogenophaga sp. YM1	2806262	S	14	6	20	0.00004
Hydrogenophaga taeniospiralis	65656	S	26	16	42	0.00008
Hydrogenophaga crassostreae	1763535	S	21	1	22	0.00004
Hydrogenophaga crocea	2716225	S	16	11	27	0.00005
Comamonas aquatica	225991	S	39	26	65	0.00012
Comamonas sp. Y33R10-2	2853257	S	10	9	19	0.00004
Comamonas kerstersii	225992	S	20	4	24	0.00005
Comamonas odontotermitis	379895	S	20	2	22	0.00004
Comamonas serinivorans	1082851	S	16	2	18	0.00003
Comamonas piscis	1562974	S	16	2	18	0.00003
Comamonas testosteroni	285	S	13	36	49	0.00009
Comamonas thiooxydans	363952	S	12	24	36	0.00007
Diaphorobacter sp. HDW4B	2714925	S	12	7	19	0.00004
Diaphorobacter sp. HDW4A	2714924	S	11	11	22	0.00004
Diaphorobacter aerolatus	1288495	S	13	23	36	0.00007
Ramlibacter tataouinensis	94132	S	67	12	79	0.00015
Delftia acidovorans	80866	S	13	24	37	0.00007
Delftia tsuruhatensis	180282	S	13	34	47	0.00009
Ottowia oryzae	2109914	S	20	2	22	0.00004
Ottowia sp. oral taxon 894	1658672	S	14	1	15	0.00003
Ottowia testudinis	2816950	S	11	1	12	0.00002
Kinneretia sp. DAIF2	2714952	S	31	6	37	0.00007
Melaminivora suipulveris	2109913	S	21	11	32	0.00006
Melaminivora jejuensis	1267217	S	15	5	20	0.00004
Limnohabitans sp. 63ED37-2	1678128	S	26	2	28	0.00005
Limnohabitans sp. 103DPR2	1678129	S	10	0	10	0.00002
Curvibacter sp. AEP1-3	1844971	S	32	1	33	0.00006
Simplicispira suum	2109915	S	28	8	36	0.00007
Hylemonella gracilis	80880	S	23	2	25	0.00005
Verminephrobacter eiseniae	364317	S	21	1	22	0.00004
Alicycliphilus denitrificans	179636	S	22	56	78	0.00015
Pulveribacter suum	2116657	S	18	7	25	0.00005
Lautropia mirabilis	47671	S	1538	120	1658	0.00317
Burkholderia multivorans	87883	S	23	6	29	0.00006
Burkholderia ubonensis	101571	S	23	18	41	0.00008
Burkholderia cepacia	292	S	15	25	40	0.00008
Burkholderia contaminans	488447	S	11	8	19	0.00004
Burkholderia cenocepacia	95486	S	10	43	53	0.00010
Burkholderia pseudomallei	28450	S	11	114	125	0.00024
Burkholderia gladioli	28095	S	16	1	17	0.00003
Cupriavidus taiwanensis	164546	S	40	41	81	0.00015
Cupriavidus pauculus	82633	S	28	11	39	0.00007
Cupriavidus basilensis	68895	S	19	11	30	0.00006
Cupriavidus necator	106590	S	18	20	38	0.00007
Cupriavidus campinensis	151783	S	15	5	20	0.00004
Cupriavidus oxalaticus	96344	S	13	5	18	0.00003
Paraburkholderia caribensis	75105	S	16	10	26	0.00005
Paraburkholderia phenoliruptrix	252970	S	14	6	20	0.00004
Paraburkholderia acidiphila	2571747	S	11	1	12	0.00002
Paraburkholderia aromaticivorans	2026199	S	11	5	16	0.00003
Paraburkholderia xenovorans	36873	S	10	10	20	0.00004
Paraburkholderia pallida	2547399	S	10	1	11	0.00002
Paraburkholderia fungorum	134537	S	10	3	13	0.00002
Paraburkholderia tropica	92647	S	10	1	11	0.00002
Polynucleobacter sp. AP-Ainpum-60-G11	2576926	S	10	13	23	0.00004
Polynucleobacter necessarius	576610	S	11	4	15	0.00003
Polynucleobacter asymbioticus	576611	S	10	4	14	0.00003
Ralstonia solanacearum	305	S	29	47	76	0.00015
Caballeronia insecticola	758793	S	11	0	11	0.00002
Ephemeroptericola cinctiostellae	2268024	S	13	0	13	0.00002
Massilia sp. HC52	2852099	S	44	22	66	0.00013
Massilia sp. LPB0304	2769491	S	24	14	38	0.00007
Massilia sp. WG5	1707785	S	19	12	31	0.00006
Massilia sp. PAMC28688	2861283	S	18	4	22	0.00004
Massilia sp. DM-R-R2A-13	2899220	S	15	5	20	0.00004
Massilia sp. H6	2970464	S	14	4	18	0.00003
Massilia sp. NP310	2861282	S	12	11	23	0.00004
Massilia violaceinigra	2045208	S	67	16	83	0.00016
Massilia putida	1141883	S	29	9	38	0.00007
Massilia antarctica	2765360	S	26	9	35	0.00007
Massilia forsythiae	2728020	S	23	4	27	0.00005
Massilia oculi	945844	S	15	9	24	0.00005
Pseudoduganella flava	871742	S	22	4	26	0.00005
Pseudoduganella lutea	321985	S	21	5	26	0.00005
Pseudoduganella albidiflava	321983	S	19	6	25	0.00005
Pseudoduganella umbonata	864828	S	15	5	20	0.00004
Pseudoduganella armeniaca	2072590	S	14	10	24	0.00005
Pseudoduganella plicata	321984	S	10	2	12	0.00002
Duganella dendranthematis	2728021	S	85	12	97	0.00019
Janthinobacterium sp. LM6	1938606	S	30	13	43	0.00008
Janthinobacterium sp. 1_2014MBL_MicDiv	1644131	S	27	7	34	0.00007
Janthinobacterium sp. HH102	1537274	S	18	29	47	0.00009
Janthinobacterium sp. PAMC25594	2861284	S	18	9	27	0.00005
Janthinobacterium agaricidamnosum	55508	S	53	28	81	0.00015
Janthinobacterium lividum	29581	S	19	46	65	0.00012
Janthinobacterium svalbardensis	368607	S	16	8	24	0.00005
Janthinobacterium tructae	2590869	S	14	7	21	0.00004
Herbaspirillum hiltneri	341045	S	16	1	17	0.00003
Herbaspirillum rubrisubalbicans	80842	S	11	4	15	0.00003
Herbaspirillum robiniae	2014887	S	11	3	14	0.00003
Herbaspirillum seropedicae	964	S	10	4	14	0.00003
Collimonas fungivorans	158899	S	26	2	28	0.00005
Collimonas arenae	279058	S	17	1	18	0.00003
Collimonas pratensis	279113	S	13	1	14	0.00003
Undibacterium sp. YM2	2058625	S	15	5	20	0.00004
Undibacterium parvum	401471	S	14	0	14	0.00003
Noviherbaspirillum sp. UKPF54	2601898	S	12	1	13	0.00002
Sphaerotilus sulfidivorans	639200	S	51	9	60	0.00011
Sphaerotilus sp. FB-5	2914710	S	47	15	62	0.00012
Schlegelella aquatica	376175	S	71	18	89	0.00017
Roseateles sp. SL47	2995138	S	14	2	16	0.00003
Roseateles depolymerans	76731	S	22	3	25	0.00005
Caldimonas thermodepolymerans	215580	S	25	10	35	0.00007
Caldimonas brevitalea	413882	S	14	1	15	0.00003
Mitsuaria sp. 7	1658665	S	31	3	34	0.00007
Aquincola tertiaricarbonis	391953	S	31	6	37	0.00007
Rubrivivax gelatinosus	28068	S	29	4	33	0.00006
Ideonella dechloratans	36863	S	29	18	47	0.00009
Methylibium petroleiphilum	105560	S	12	11	23	0.00004
Inhella inkyongensis	392593	S	10	0	10	0.00002
Achromobacter sp. AONIH1	1758194	S	10	8	18	0.00003
Achromobacter sp. MFA1 R4	1881016	S	10	5	15	0.00003
Achromobacter xylosoxidans	85698	S	22	35	57	0.00011
Achromobacter denitrificans	32002	S	15	13	28	0.00005
Achromobacter spanius	217203	S	12	3	15	0.00003
Achromobacter pestifer	1353889	S	10	7	17	0.00003
Bordetella genomosp. 8	1416806	S	11	19	30	0.00006
Alcaligenes faecalis	511	S	14	18	32	0.00006
Orrella dioscoreae	1851544	S	12	2	14	0.00003
Rhizobacter gummiphilus	946333	S	45	6	51	0.00010
Rhizobacter sp. AJA081-3	2753607	S	34	6	40	0.00008
Leptothrix cholodnii	34029	S	42	9	51	0.00010
Aquabacterium sp. J223	2898431	S	28	5	33	0.00006
Aquabacterium olei	1296669	S	12	2	14	0.00003
Thiomonas sp. X19	1050370	S	10	7	17	0.00003
Paucibacter sp. KCTC 42545	1768242	S	27	2	29	0.00006
Xylophilus rhododendri	2697032	S	20	4	24	0.00005
Thauera sp. MZ1T	85643	S	11	7	18	0.00003
Thauera chlorobenzoica	96773	S	10	9	19	0.00004
Parazoarcus communis	41977	S	15	2	17	0.00003
Dechloromonas sp. HYN0024	2231055	S	13	1	14	0.00003
Dechloromonas denitrificans	281362	S	24	6	30	0.00006
Ferribacterium limneticum	76259	S	38	3	41	0.00008
Aromatoleum petrolei	76116	S	15	6	21	0.00004
Oryzomicrobium terrae	1735038	S	13	0	13	0.00002
Methylotenera versatilis	1055487	S	14	4	18	0.00003
Denitratisoma oestradiolicum	311182	S	10	0	10	0.00002
Sulfuritalea hydrogenivorans	748811	S	11	1	12	0.00002
Usitatibacter palustris	2732487	S	17	1	18	0.00003
Usitatibacter rugosus	2732067	S	16	1	17	0.00003
Casimicrobium huifangae	2591109	S	10	2	12	0.00002
Bradyrhizobium sp. 200	2782665	S	29	21	50	0.00010
Bradyrhizobium sp. 170	2782641	S	25	22	47	0.00009
Bradyrhizobium sp. A19	2898149	S	15	4	19	0.00004
Bradyrhizobium sp. 186	2782654	S	14	13	27	0.00005
Bradyrhizobium sp. WD16	1521768	S	13	3	16	0.00003
Bradyrhizobium sp. SK17	2057741	S	13	11	24	0.00005
Bradyrhizobium sp. CCBAU 051011	858422	S	13	4	17	0.00003
Bradyrhizobium sp. CCBAU 51753	1325100	S	13	5	18	0.00003
Bradyrhizobium sp. ORS 278	114615	S	11	5	16	0.00003
Bradyrhizobium sp. ORS 285	115808	S	11	5	16	0.00003
Bradyrhizobium erythrophlei	1437360	S	105	10	115	0.00022
Bradyrhizobium sediminis	2840469	S	54	11	65	0.00012
Bradyrhizobium diazoefficiens	1355477	S	41	85	126	0.00024
Bradyrhizobium canariense	255045	S	35	99	134	0.00026
Bradyrhizobium lablabi	722472	S	25	48	73	0.00014
Bradyrhizobium icense	1274631	S	24	5	29	0.00006
Bradyrhizobium arachidis	858423	S	17	37	54	0.00010
Bradyrhizobium genosp. L	83637	S	13	3	16	0.00003
Bradyrhizobium japonicum	375	S	13	25	38	0.00007
Bradyrhizobium genosp. B	83627	S	12	3	15	0.00003
Bradyrhizobium daqingense	993502	S	12	9	21	0.00004
Bradyrhizobium cosmicum	1404864	S	11	4	15	0.00003
Bradyrhizobium quebecense	2748629	S	11	9	20	0.00004
Bradyrhizobium oligotrophicum	44255	S	11	2	13	0.00002
Bradyrhizobium paxllaeri	190148	S	10	2	12	0.00002
Rhodopseudomonas palustris	1076	S	69	23	92	0.00018
Rhodopseudomonas sp. SK50-23	340268	S	24	5	29	0.00006
Rhodopseudomonas sp. P2A-2r	2991972	S	18	4	22	0.00004
Rhodopseudomonas boonkerdii	475937	S	13	5	18	0.00003
Afipia sp. GAS231	1882747	S	18	14	32	0.00006
Afipia carboxidovorans	40137	S	10	-10	0	0.00000
Rhizobium leguminosarum	384	S	45	79	124	0.00024
Rhizobium jaguaris	1312183	S	12	1	13	0.00002
Agrobacterium tumefaciens	358	S	27	35	62	0.00012
Agrobacterium vitis	373	S	11	12	23	0.00004
Ensifer adhaerens	106592	S	24	15	39	0.00007
Sinorhizobium fredii	380	S	10	19	29	0.00006
Shinella sp. XGS7	2877941	S	23	11	34	0.00007
Shinella sp. HZN7	879274	S	17	29	46	0.00009
Shinella zoogloeoides	352475	S	10	32	42	0.00008
Mesorhizobium sp. AR07	2865838	S	10	89	99	0.00019
Nitratireductor sp. OM-1	1756988	S	10	2	12	0.00002
Aquibium oceanicum	1670800	S	11	8	19	0.00004
Methylobacterium sp. FF17	2984843	S	16	6	22	0.00004
Methylobacterium sp. 4-46	426117	S	10	4	14	0.00003
Methylobacterium aquaticum	270351	S	19	48	67	0.00013
Methylobacterium nodulans	114616	S	18	4	22	0.00004
Methylobacterium durans	2202825	S	12	4	16	0.00003
Methylobacterium brachiatum	269660	S	10	21	31	0.00006
Methylorubrum extorquens	408	S	12	30	42	0.00008
Microvirga ossetica	1882682	S	11	4	15	0.00003
Hyphomicrobium sp. DMF-1	3019544	S	13	1	14	0.00003
Hyphomicrobium denitrificans	53399	S	16	4	20	0.00004
Hyphomicrobium nitrativorans	1427356	S	11	1	12	0.00002
Rhodoplanes sp. Z2-YC6860	674703	S	49	9	58	0.00011
Caenibius tardaugens	169176	S	15	72	87	0.00017
Methyloligella sp. GL2	2742204	S	12	1	13	0.00002
Devosia sp. A16	1736675	S	19	5	24	0.00005
Devosia sp. SL43	2806348	S	16	11	27	0.00005
Pseudolabrys taiwanensis	331696	S	32	9	41	0.00008
Pseudolabrys sp. FHR47	2562284	S	14	4	18	0.00003
Ancylobacter sp. SL191	2995166	S	17	9	26	0.00005
Xanthobacter dioxanivorans	2528964	S	12	16	28	0.00005
Starkeya sp. ORNL1	2709380	S	11	3	14	0.00003
Bosea sp. Tri-49	1867715	S	16	5	21	0.00004
Bosea sp. NBC_00550	2969621	S	14	7	21	0.00004
Bosea sp. ANAM02	2020412	S	13	10	23	0.00004
Bosea sp. PAMC 26642	1792307	S	11	3	14	0.00003
Bosea sp. RAC05	1842539	S	11	5	16	0.00003
Brucella intermedia	94625	S	11	30	41	0.00008
Methylocystis parvus	134	S	13	6	19	0.00004
Nordella sp. HKS 07	2712222	S	12	0	12	0.00002
Pseudorhodoplanes sinuspersici	1235591	S	10	1	11	0.00002
Phreatobacter cathodiphilus	1868589	S	11	5	16	0.00003
Blastochloris tepida	2233851	S	10	6	16	0.00003
Acuticoccus sp. I52.16.1	2928472	S	14	2	16	0.00003
Kaistia sp. 32K	2795690	S	10	5	15	0.00003
Sphingomonas sp. PAMC26645	2565555	S	80	25	105	0.00020
Sphingomonas sp. HMP9	1517554	S	40	17	57	0.00011
Sphingomonas sp. AAP5	1523415	S	36	24	60	0.00011
Sphingomonas sp. CV7422	3018036	S	18	10	28	0.00005
Sphingomonas sp. SUN039	2937787	S	17	1	18	0.00003
Sphingomonas sp. QA11	2950605	S	17	2	19	0.00004
Sphingomonas sp. ZFBP2030	2972485	S	17	2	19	0.00004
Sphingomonas sp. MM-1	745310	S	16	47	63	0.00012
Sphingomonas sp. NIBR 02145	3014784	S	16	3	19	0.00004
Sphingomonas sp. J315	2898433	S	15	8	23	0.00004
Sphingomonas sp. KC8	1030157	S	14	2	16	0.00003
Sphingomonas sp. R1	399176	S	14	6	20	0.00004
Sphingomonas sp. HMP6	1517551	S	13	2	15	0.00003
Sphingomonas sp. PAMB00755	3012344	S	13	2	15	0.00003
Sphingomonas sp. SUN019	2937788	S	13	1	14	0.00003
Sphingomonas sp. CL5.1	2653203	S	13	9	22	0.00004
Sphingomonas sp. S6-11	2991075	S	11	1	12	0.00002
Sphingomonas sp. FARSPH	2219696	S	11	13	24	0.00005
Sphingomonas sp. AP4-R1	2735134	S	11	1	12	0.00002
Sphingomonas sp. NBWT7	2596913	S	10	6	16	0.00003
Sphingomonas sp. HDW15A	2714942	S	10	0	10	0.00002
Sphingomonas panacis	1560345	S	20	3	23	0.00004
Sphingomonas aliaeris	2759526	S	19	2	21	0.00004
Sphingomonas taxi	1549858	S	18	8	26	0.00005
Sphingomonas panacisoli	1813879	S	17	2	19	0.00004
Sphingomonas sabuli	2764186	S	16	2	18	0.00003
Sphingomonas alpina	653931	S	16	2	18	0.00003
Sphingomonas hengshuiensis	1609977	S	16	2	18	0.00003
Sphingomonas aerolata	185951	S	15	5	20	0.00004
Sphingomonas radiodurans	2890321	S	14	1	15	0.00003
Sphingomonas sanxanigenens	397260	S	14	21	35	0.00007
Sphingomonas naphthae	1813468	S	14	13	27	0.00005
Sphingomonas cannabina	2899123	S	13	9	22	0.00004
Sphingomonas rhizophila	2071607	S	13	4	17	0.00003
Sphingomonas ginsengisoli An et al. 2013	363835	S	12	2	14	0.00003
Sphingomonas glaciei	2938948	S	11	1	12	0.00002
Sphingomonas hankookensis	563996	S	11	17	28	0.00005
Sphingomonas paucimobilis	13689	S	10	13	23	0.00004
Novosphingobium sp. Gsoil 351	2675225	S	17	1	18	0.00003
Novosphingobium sp. P6W	1609758	S	15	1	16	0.00003
Novosphingobium sp. EMRT-2	2571749	S	14	18	32	0.00006
Novosphingobium sp. Sx8-5	2896849	S	13	1	14	0.00003
Novosphingobium sp. KACC 22771	3025670	S	12	1	13	0.00002
Novosphingobium sp. ES2-1	2780074	S	11	7	18	0.00003
Novosphingobium sp. 9	2025349	S	10	1	11	0.00002
Novosphingobium ginsenosidimutans	1176536	S	20	2	22	0.00004
Novosphingobium resinovorum	158500	S	13	19	32	0.00006
Novosphingobium aromaticivorans	48935	S	12	44	56	0.00011
Sphingopyxis sp. USTB-05	2830667	S	10	15	25	0.00005
Sphingopyxis macrogoltabida	33050	S	13	40	53	0.00010
Rhizorhabdus dicambivorans	1850238	S	21	64	85	0.00016
Rhizorhabdus wittichii	160791	S	14	20	34	0.00007
Sphingorhabdus lacus	392610	S	18	0	18	0.00003
Sphingomicrobium flavum	1229164	S	11	0	11	0.00002
Altererythrobacter sp. TH136	2067415	S	11	7	18	0.00003
Croceicoccus sp. YJ47	2798724	S	10	18	28	0.00005
Tsuneonella amylolytica	2338327	S	11	11	22	0.00004
Sphingosinicella sp. BN140058	1892855	S	17	1	18	0.00003
Sphingosinicella microcystinivorans	335406	S	12	10	22	0.00004
Paracoccus alcaliphilus	34002	S	12	26	38	0.00007
Paracoccus jeotgali	2065379	S	12	14	26	0.00005
Paracoccus saliphilus	405559	S	12	3	15	0.00003
Gemmobacter fulva	2840474	S	25	21	46	0.00009
Gemmobacter aquarius	2169400	S	23	13	36	0.00007
Rhodobacter sp. LPB0142	1850250	S	12	35	47	0.00009
Cereibacter sphaeroides	1063	S	17	15	32	0.00006
Tabrizicola piscis	2494374	S	11	3	14	0.00003
Mameliella alba	561184	S	10	37	47	0.00009
Brevundimonas sp. NIBR10	3015997	S	21	11	32	0.00006
Brevundimonas sp. NIBR11	3015999	S	21	10	31	0.00006
Brevundimonas sp. LM2	1938605	S	15	11	26	0.00005
Brevundimonas sp. M20	2591463	S	14	5	19	0.00004
Brevundimonas subvibrioides	74313	S	17	8	25	0.00005
Brevundimonas goettingensis	2774190	S	17	5	22	0.00004
Brevundimonas naejangsanensis	588932	S	16	13	29	0.00006
Brevundimonas pondensis	2774189	S	12	10	22	0.00004
Brevundimonas mediterranea	74329	S	11	16	27	0.00005
Brevundimonas albigilva	1312364	S	10	18	28	0.00005
Caulobacter sp. NIBR1757	3016000	S	19	3	22	0.00004
Caulobacter sp. S6	2823693	S	15	2	17	0.00003
Caulobacter sp. NIBR2454	3015996	S	15	5	20	0.00004
Caulobacter segnis	88688	S	29	11	40	0.00008
Caulobacter soli	2708539	S	25	9	34	0.00007
Caulobacter vibrioides	155892	S	20	10	30	0.00006
Caulobacter mirabilis	69666	S	16	4	20	0.00004
Caulobacter flavus	1679497	S	14	5	19	0.00004
Caulobacter rhizosphaerae	2010972	S	13	4	17	0.00003
Caulobacter henricii	69395	S	12	2	14	0.00003
Phenylobacterium sp. NIBR 498073	3015177	S	13	3	16	0.00003
Phenylobacterium sp. LH3H17	2903901	S	12	2	14	0.00003
Phenylobacterium zucineum	284016	S	18	6	24	0.00005
Phenylobacterium parvum	2201350	S	12	1	13	0.00002
Terricaulis silvestris	2686094	S	15	0	15	0.00003
Roseomonas sp. S08	1750527	S	13	1	14	0.00003
Roseomonas cervicalis	204525	S	18	6	24	0.00005
Roseomonas gilardii	257708	S	14	9	23	0.00004
Rhodovastum atsumiense	504468	S	15	2	17	0.00003
Roseococcus microcysteis	2771361	S	12	3	15	0.00003
Azospirillum thiophilum	528244	S	12	7	19	0.00004
Azospirillum brasilense	192	S	11	28	39	0.00007
Azospirillum thermophilum	2202148	S	11	4	15	0.00003
Niveispirillum cyanobacteriorum	1612173	S	10	4	14	0.00003
Hypericibacter terrae	2602015	S	16	4	20	0.00004
Ferrovibrio terrae	2594003	S	13	1	14	0.00003
Stella humosa	94	S	14	1	15	0.00003
Elioraea tepida	2843330	S	12	0	12	0.00002
Candidatus Viadribacter manganicus	1759059	S	10	0	10	0.00002
Fusobacterium pseudoperiodonticum	2663009	S	2111	439	2550	0.00488
Fusobacterium nucleatum	851	S	1026	175	1201	0.00230
Fusobacterium periodonticum	860	S	268	243	511	0.00098
Fusobacterium hwasookii	1583098	S	60	52	112	0.00021
Fusobacterium canifelinum	285729	S	13	3	16	0.00003
Leptotrichia sp. oral taxon 212	712357	S	1512	49	1561	0.00298
Leptotrichia sp. oral taxon 221	712362	S	214	31	245	0.00047
Leptotrichia sp. oral taxon 218	712361	S	48	14	62	0.00012
Leptotrichia sp. oral taxon 498	712368	S	27	8	35	0.00007
Leptotrichia sp. oral taxon 847	1785996	S	27	4	31	0.00006
Leptotrichia wadei	157687	S	723	99	822	0.00157
Leptotrichia hongkongensis	554406	S	93	12	105	0.00020
Leptotrichia hofstadii	157688	S	82	11	93	0.00018
Leptotrichia trevisanii	109328	S	80	7	87	0.00017
Leptotrichia shahii	157691	S	42	6	48	0.00009
Leptotrichia buccalis	40542	S	32	3	35	0.00007
Pseudoleptotrichia goodfellowii	157692	S	32	0	32	0.00006
Campylobacter concisus	199	S	2667	30	2697	0.00516
Campylobacter rectus	203	S	261	6	267	0.00051
Campylobacter gracilis	824	S	81	0	81	0.00015
Campylobacter showae	204	S	76	1	77	0.00015
Arcobacter venerupis	1054033	S	13	6	19	0.00004
Arcobacter suis	1278212	S	11	6	17	0.00003
Aliarcobacter cryaerophilus	28198	S	30	9	39	0.00007
Helicobacter pylori	210	S	12	1	13	0.00002
Bremerella volcania	2527984	S	10	2	12	0.00002
Anatilimnocola aggregata	2528021	S	19	3	22	0.00004
Stieleria neptunia	2527979	S	11	1	12	0.00002
Lignipirellula cremea	2528010	S	17	2	19	0.00004
Pirellula sp. SH-Sr6A	1632865	S	10	0	10	0.00002
Lacipirellula parvula	2650471	S	22	3	25	0.00005
Lacipirellula limnantheis	2528024	S	16	3	19	0.00004
Pirellulimonas nuda	2528009	S	22	2	24	0.00005
Gemmata obscuriglobus	114	S	24	2	26	0.00005
Gemmata sp. SH-PL17	1630693	S	14	9	23	0.00004
Urbifossiella limnaea	2528023	S	42	3	45	0.00009
Limnoglobus roseus	2598579	S	35	1	36	0.00007
Frigoriglobus tundricola	2774151	S	24	3	27	0.00005
Planctomyces sp. SH-PL14	1632864	S	27	2	29	0.00006
Planctomyces sp. SH-PL62	1636152	S	14	8	22	0.00004
Gimesia panareensis	2527978	S	12	6	18	0.00003
Symmachiella dynata	2527995	S	14	1	15	0.00003
Maioricimonas rarisocia	2528026	S	12	3	15	0.00003
Caulifigura coniformis	2527983	S	12	0	12	0.00002
Tautonia plasticadhaerens	2527974	S	27	2	29	0.00006
Aquisphaera giovannonii	406548	S	26	5	31	0.00006
Singulisphaera acidiphila	466153	S	22	5	27	0.00005
Paludisphaera borealis	1387353	S	18	6	24	0.00005
Humisphaera borealis	2807512	S	17	0	17	0.00003
Opitutus sp. GAS368	1882749	S	57	6	63	0.00012
Opitutus terrae	107709	S	22	0	22	0.00004
Lacunisphaera limnophila	1838286	S	41	4	45	0.00009
Horticoccus luteus	2862869	S	23	0	23	0.00004
Nibricoccus aquaticus	2576891	S	18	0	18	0.00003
Luteolibacter ambystomatis	2824561	S	29	1	30	0.00006
Luteolibacter sp. SL250	2995170	S	20	1	21	0.00004
Luteolibacter luteus	2728835	S	12	0	12	0.00002
Verrucomicrobium spinosum	2736	S	27	2	29	0.00006
Verrucomicrobium sp. GAS474	1882831	S	17	3	20	0.00004
Roseimicrobium sp. ORNL1	2711231	S	20	0	20	0.00004
Sulfuriroseicoccus oceanibius	2707525	S	11	1	12	0.00002
Akkermansia muciniphila	239935	S	16	4	20	0.00004
Treponema denticola	158	S	233	76	309	0.00059
Treponema sp. OMZ 803	120682	S	35	40	75	0.00014
Treponema sp. OMZ 906	2563662	S	32	37	69	0.00013
Treponema sp. Marseille-Q4132	2766701	S	30	0	30	0.00006
Treponema sp. OMZ 305	1659192	S	16	9	25	0.00005
Treponema sp. OMZ 857	1643513	S	15	16	31	0.00006
Treponema socranskii	53419	S	93	1	94	0.00018
Treponema vincentii	69710	S	63	10	73	0.00014
Treponema medium	58231	S	57	5	62	0.00012
Treponema putidum	221027	S	15	0	15	0.00003
Sorangium cellulosum	56	S	90	38	128	0.00024
Polyangium aurulentum	2567896	S	18	1	19	0.00004
Chondromyces crocatus	52	S	16	0	16	0.00003
Sandaracinus amylolyticus	927083	S	51	1	52	0.00010
Labilithrix luteola	1391654	S	31	0	31	0.00006
Nannocystis sp. fl3	2995304	S	32	1	33	0.00006
Haliangium ochraceum	80816	S	26	0	26	0.00005
Myxococcus xanthus	34	S	11	27	38	0.00007
Pyxidicoccus sp. SCPEA002	2813578	S	15	3	18	0.00003
Anaeromyxobacter oryzae	2918170	S	22	0	22	0.00004
Anaeromyxobacter sp. Fw109-5	404589	S	14	1	15	0.00003
Anaeromyxobacter dehalogenans	161493	S	13	11	24	0.00005
Anaeromyxobacter paludicola	2918171	S	11	0	11	0.00002
Archangium violaceum	83451	S	25	7	32	0.00006
Archangium gephyra	48	S	13	4	17	0.00003
Granulicella sp. WH15	2602070	S	11	3	14	0.00003
Granulicella mallensis	940614	S	10	0	10	0.00002
Terriglobus roseus	392734	S	12	1	13	0.00002
Candidatus Koribacter versatilis	658062	S	10	0	10	0.00002
Paludibaculum fermentans	1473598	S	19	0	19	0.00004
Luteitalea pratensis	1855912	S	41	3	44	0.00008
Luteitalea sp. TBR-22	2802971	S	36	4	40	0.00008
Candidatus Nanosynbacter sp. HMT-352	2899133	S	61	22	83	0.00016
Candidatus Nanosynbacter featherlites	2572088	S	24	3	27	0.00005
Bdellovibrio bacteriovorus	959	S	12	3	15	0.00003
Bacteriovorax stolpii	960	S	17	0	17	0.00003
Nitrospira moscoviensis	42253	S	16	0	16	0.00003
Persicimonas caeni	2292766	S	14	0	14	0.00003
Saccharomyces cerevisiae	4932	S	1920	500	2420	0.00463
Saccharomyces paradoxus	27291	S	15	1	16	0.00003
Purpureocillium takamizusanense	2060973	S	11	1	12	0.00002
Colletotrichum lupini	145971	S	10	1	11	0.00002
Puccinia triticina	208348	S	18	0	18	0.00003
Homo sapiens	9606	S	798	52	850	0.00163
Plasmodium malariae	5858	S	11	1	12	0.00002
Thalassiosira pseudonana	35128	S	21	1	22	0.00004
Trypanosoma brucei	5691	S	11	1	12	0.00002
Trichomonas vaginalis	5722	S	19	0	19	0.00004
Vhmlvirus VP585	1922213	S	80	92	172	0.00033
Vhmlvirus mar	1922211	S	28	40	68	0.00013
Streptococcus phage 5093	646413	S	27	14	41	0.00008
Streptococcus phage PH10	644007	S	10	0	10	0.00002
Vequintavirus FV3	1914855	S	29	21	50	0.00010
